"   S                        " +
"   S      $         $      $" +
"HX#H    H###H     H###H#  #H" +
"H  ######   H#####H   H  $ H" +
"H$ 0        H     H   #### H" +
"HX####         ###H#       H" +
"H @####       ##        H# H" +
"H @#####     ##       H#H  H" +
"H @###########    $   H   ##" +
"H @###########   ###  H     " +
"H @    ### ###        H   0$" +
"H @  $ ## $ ##     0  H   ##" +
"H @H###########H######H   ##" +
"H  H           H      H   ##" +
"H  H       &          H   ##" +
"############################",
