"              S             " +
"              S             " +
"              S             " +
" ------   0  H#H  0   ------" +
"      H---H#$H#H$#H---H     " +
" H#$ #H   H#######H   H# $#H" +
" H####    H-H# #H-H    ####H" +
" HH##       H###H       ##HH" +
"  H##       H# #H       ##H " +
"  H##       H###H       ##H " +
"  H##       H# #H       ##H " +
"  H##       H###H       ##H " +
"  H##       H# #H &   0 ##H " +
"  H#########H###H#########H " +
"$ H##   $  #H $ H#  $   ##H$" +
"@@@@@@@@@@@@@@@@@@@@@@@@@@@@",
