"                            " +
"          SSSSSSSS          " +
"          H######H          " +
"        0 H# 0  #H 0        " +
"          H#  $ #H          " +
"     H################H     " +
"     H#    #    #    #H     " +
"     H#    #    #    #H     " +
"     H#    #    #    #H     " +
"     H#  $ #0 $ #  $ #H     " +
"H#############X############H" +
"H#    #    #    #    #    #H" +
"H#    #    #    #    #    #H" +
"H#  $ #  $ #  $ #  $ #  $ #H" +
"H#H##H#H##H#H##H#H##H#H##H#H" +
"H H##H H##H&H##H0H##H H##H H",
