"S                          S" +
"S                          S" +
"S-----H     H------H#     #H" +
"      H-----H      H# $   #H" +
" $    H     H 0 $  H#####X#H" +
"### $ #HH   #############X#H" +
"####### H $          $     H" +
"#####$  H##   $#$   ##     H" +
"######$ H##  $###$  ##     H" +
"#######$H## $#####$ ## 0 $ H" +
"########H##X###########H@@#H" +
"#      0H              H ##H" +
"#  $  ##H       &      H ##H" +
"########H----H####H$---H ##H" +
"#  $    H  $ H##$#H#  #H$##H" +
"##################H####H###H",
