"@                          S" +
"@     $$$$0 0 0      &     S" +
"@##########X###############H" +
"                           H" +
"    @ $  $       $      $@ H" +
"    @#######X#######X####@ H" +
"                           H" +
"      @  $    $     $  @   H" +
"      @###X######X#####@   H" +
"                           H" +
"       @  $     $    $@    H" +
"      @@##############@    H" +
"                           H" +
"                           H" +
"$$$$   0          0     H@ H" +
"##########@@@@@@#######@@@ H",
