"      $     $           H   " +
"H#################H     H   " +
"H             $   H-----H  $" +
"#########H#########     H###" +
"########HH              H   " +
"#######HH-------H       H   " +
"#$ $##HH      0 H  $  0 H  $" +
"#####HH     H####@@@####H###" +
"     H      H           H   " +
"     H      H           H   " +
"    0H   $  H-----------H  $" +
"H###########H  $     $  H###" +
"H           H ######### H   " +
"H           H           H   " +
"H      $    H    & $    H   " +
"############################",
