"-----------                 " +
"           H     #   - -    " +
"  $  $  $ 0H---- #### H ####" +
"###########     H#### H X###" +
"$$       $$ ----H#### H X###" +
"##$     $##H     # ## H X$$#" +
"###$   $###H---- # ## H X###" +
"####$ $####     H# ## H X$$#" +
"#####$#####  0  H# ## H X###" +
"###########H######$$# H X$$#" +
"           H     #### H X###" +
"#S#    &   H         0H X$$#" +
"#S###########H##########X###" +
"#S    ###$###H#####$        " +
"#S    ####$##H##$ $##H     $" +
"#S$  $#####  H  ############",
