"S                           " +
"S   $   $   $0 0$   $   $   " +
"##############S#############" +
"              H             " +
"             #H#            " +
"             $H$            " +
"   0        ##H##       0   " +
"   H        $ H $       H   " +
"  #H#      ###H###     #H#  " +
"  $H$      $  H  $     $H$  " +
" ##H##    ####H####   ##H## " +
" $ H $    $   H   $   $ H $ " +
"###H###  #####H##### ###H###" +
"$  H  $  $    H    $ $  H  $" +
"   H          H &       H   " +
"############################",
