" ----      $$$$$$$     ---- " +
"H    ##################    H" +
"H @@@##################@@@ H" +
"H    ##################    H" +
"H0@H ################## H@0H" +
"@@@H #    #    #    ### H@@@" +
"   H #$$$$#$$$$#$$$$### H   " +
"   H ################## H   " +
"   H ################## H   " +
"   H ################## H   " +
"   H ###    #    #    # H   " +
"   H ###$$$$#$$$$#$$$$# H   " +
"   H ################## H   " +
"   H ################## H   " +
"   H ################## H   " +
"   H                   &H   ",
