"               -----        " +
"          ----H     0$  $   " +
"     ----H      0 $ #######H" +
" ---H         $ #####  $  #H" +
"H         &$ ####   $0#X#H#H" +
"H  X#X ## ####  $ #X### #H#H" +
"H  $ $ $  #  $ ##X#  $  #H#H" +
"H ## X#X  # ####   $###H#H#H" +
"H  $ $ $  # #  $ #X#X #H#H#H" +
"H  ### X# # # ##X#  $ #H#H#H" +
"H  $ $ $  # # #  $ ##H#H#H#H" +
"H #X X##  # # # #####H#H#H#H" +
"H  $ $ $  # # # #   #H#H#H#H" +
"H  ##X X# # # # # $ #H#H#H#H" +
"H        0# # # #####H#H#H#H" +
"###########          H H H H",
