"  H   0    -   0-H    H-   $" +
" -H   -H-   -  - H-   H -  H" +
"- H  - H -    -  H -  H  - H" +
"$ H -  H  -  -   H  -$H   -H" +
"  H-  -H   --    H$  -H    H" +
"H-   - H-  --  - H------ -  " +
"H -   -H  -$ -   H  -   H - " +
"H- -   H$--H  -  H     -H  -" +
"H - -  H-- H   - H    - H  -" +
"H- $ -0H-  H -  -H-  -  H  -" +
"H -H  -    H   -   -    H  -" +
"H- H   -   H  - -   -   H  -" +
"H -H -  -  H$-   -   -  H $-" +
"H- H   - - H- -  $-   - H - " +
"H -H  -   -H     - - - -H-  " +
"   H     $     $&       H   ",
