"           S    S           " +
"           S    S           " +
"   $ 0   H#S    S#H   0 $   " +
"H#####H--H#S    S#H--H#####H" +
"H#   #H   #S    S#   H#   #H" +
"H#   #H   #S    S#   H#   #H" +
"H# $ #H   #S    S#   H# $ #H" +
"H#####H   #S    S#   H#####H" +
"H#   #H   #S    S#   H#   #H" +
"H#   #H---#H####H#---H#   #H" +
"H#   #   H#H    H#H   #   #H" +
"H#0$ #   H#H  $0H#H   # $0#H" +
"H##X##   H#@@@@@@#H   ##X##H" +
"H     X  H        H  X     H" +
"H      X0H    &   H X      H" +
"############################",
