"             S              " +
"             S              " +
"$            SS            $" +
"#H H----------S---------H H#" +
"##HH 0                $ HH##" +
"###H H------ ---------H H###" +
"####HH $              HH####" +
"####XH H------ -----H0HX####" +
"####X#HH          $ HH#X####" +
"####X##H H--- ----H H##X####" +
"####X###HH $      HH###X####" +
"####X####H H-- -H H####X####" +
"####X#####HH    HH#####X####" +
"####X######H    H######X####" +
"####X#######H&$H#######X####" +
"####0       H##H        ####",
