"              0  $          " +
"         $  ######H# $      " +
"     ###X####     H#####X#  " +
"     #      #     H#     #  " +
"     # 0$   #     H#     #  " +
" ######## $ #$  #H#####$$#  " +
" #      ###X#####H    #X####" +
" #      #     $ #H 0$    - #" +
" #      #    H########### H#" +
" #   $ $#    H#         $ H#" +
" #  #####    H# $  H#H H####" +
" ####   # $#H####  H###X#   " +
"    # $ ####H   # $H#       " +
"    #####  #H   ###X#       " +
"            H      &        " +
"@#@#@#@#@#@#@#@#@#@#@#@#@#@#",
