"S                           " +
"S                           " +
"###############H## $      & " +
"    0     0    H##X#@@@@@@@H" +
"$  HHHHHHHHHHH H           H" +
"#$ H  HHHHHHHH H $ $ H#####H" +
" #$H  H        H #S# ######H" +
"  #H  H$ $ $ $  H #        H" +
"   #$ H#X#X#X# H     0$ $ $H" +
"    # H         H    #H####H" +
"      H H H H  H      H     " +
"      H         H     H 0   " +
"       H H H   H      #####H" +
"        H H H   H          H" +
"    0    $S#   H   0       H" +
"############################",
