"                        S   " +
"   $                    S   " +
"H@##                    S@@H" +
"H@$## $                $S@@H" +
"H  #$###          0 #######H" +
"H  # #  ###$     ### $     H" +
"H--  #$ #  #  $ ##$ @@@@   H" +
"H  ######   ###X#      ###@H" +
"H$ &             #@@@H# $  H" +
"H@@@@--------        H###$ H" +
"H   @    0$$$$       H  ####" +
"H $ @$  @@@@@@@@@@   H $@  $" +
"H#####               H##@@##" +
"H----H------         H      " +
"     H               H0     " +
"   $ H   ###################",
