"   $                       H" +
"H@@#@@H           $        H" +
"H     H    H#########H $   H" +
"H $ 0 H    H         H####XH" +
"H#@#@#H    H         H     S" +
"H     H----H------  0H     S" +
"H     H    H     H###@@@@@@H" +
"H     H    H  $  H         H" +
"H   0 H $  H#####H         H" +
"@###@##@##@H         H###H##" +
"@###@      H         H   H  " +
"@$  @      H   ------H   H $" +
"########H###@@@@     H  ####" +
"        H            H      " +
"        H   &        H      " +
"############################",
