"            0              S" +
"    $                 $    S" +
"  H###H    ##H##    H###H  S" +
" H# $ #HH##HHHHH##HH# $ #H S" +
"#H#####H##HHHHHHH#H######H#S" +
"     0   HHHH$HHHH         S" +
"#########HHHHHHHHH#########S" +
" ##$##   #HHHHHHH#  ##$##  S" +
"  ###     #HHHHH#    ###   S" +
"   #       #HHH#      #    S" +
"            #H#            S" +
"            #H#            S" +
"            #H#            S" +
"            #H#            S" +
"    0        H     &       S" +
"###########################S",
