"                            " +
"###S####         ------ 0   " +
"   S --  0            @@@@@H" +
"   H#  #####H######---   # H" +
"H####  #$---H-----#   ####H#" +
"H      ####   ###H#   #$  H " +
"H      #----H----H#   #-  H " +
"H &#   #H$#$H$#H$H#   #   H$" +
"#H##   ############   ##H###" +
" H    $#     $    #     H   " +
" H    ##   ###H   #     H   " +
" H  $# #      H   #$  H#####" +
" H  #  #   $  H   ##  H     " +
" H$#   # H######H # #$H     " +
" H#  $ # H#  $ #H    #H     " +
"############################",
