"       S                    " +
"       S                    " +
"       S   H@@@@@@@@@@@@@@@@" +
"##HH###H###H     0   -------" +
"#$#H# #H# #H############  $ " +
"# #H#$#H#$#HHHH$HHHH$HHH###H" +
"#XHH###H# #HH@@@@HH@@@HH   H" +
"HHHHHHHHHHHHH@  $HH@  HH##H$" +
"HH    H ## HH@ -@HH@ $HH# H#" +
"HH ###H #$#HH@@@@HH@@@HH#H #" +
"HH #$ H  ##HH---- HHHHHH#H  " +
"HH ## H # #H  $   HHHHH####H" +
"HH    H&## H#######  $H###$H" +
"HHHHHHH@@@@H#HHHHH@ ##H### H" +
"H     $  @@H#H H H@ ##H ##H#" +
"#####H   0  #H H$H@  $H# 0H#",
