"             S              " +
"             S              " +
"         H   S            H " +
"   ######H   H------------H " +
"   #  $ #H   H          0 H " +
"   #    #H   H@@@@@@##@@##@@" +
"@#@@#@@#@@#@@H#-----#X###  #" +
" $0 $     $  H# H   #-- #  #" +
"#######X#####H# H#$$#$#H#$ #" +
" ------------H# H####X#H#  #" +
"H0           H# H$   --HHH##" +
"H############H######H $  H  " +
"H           &H      H##  HHH" +
"H$##### $ ###H## $ #H#$--  H" +
"H## $ #####$ H$#####H##$ ##H" +
"####################H  #####",
