"                          S " +
"     0                    S " +
"H##########H  0  $     $  S " +
"H          H#####H   ###H###" +
"H $      $ H    @H      H   " +
"H #  ### # H $$ @H    0 H   " +
"H # ###  # H @@ @#########@@" +
"H #  ### # H @@           @$" +
"H # ###  # H @-------  $  @H" +
"H #$ ### # H @$      ####H@H" +
"H #####  # H @@          H H" +
"H ######## H @@    $     H##" +
"H          H @@ ######   H  " +
"H@@@@@@@@#@@@@@          H  " +
"H             &          H  " +
"############################",
