"            $               " +
" ------- ####H&             " +
"H          $ H    $      $  " +
"H        H@@@@ #######H#####" +
"H        H $          H     " +
"H######H ####H        H     " +
"H      H   $ H0H###########H" +
"H      H H@@@@ H@@@@@@@@@@@H" +
"H    $H# H$    H@     $   @H" +
"H    H#  ####H H@H@@@@@@@H@H" +
"H  $H#      $H H@H@   $  H@H" +
"H  H#    H@@@@ H@H@@@@@@@@@H" +
"H H#     H $   H@H    $    H" +
"HH#      ####H H@@@@@@@@@@@@" +
"HH  0        S H    0       " +
"############################",
