"  S                         " +
"  S                 --------" +
"  S          0      H      H" +
"#####H#    #H###   0H    $ H" +
"     H      H    ###H#######" +
"  0  H   $  H       H       " +
"#####H####  H       H       " +
"     H      H       H       " +
"  $  H   $  H       H       " +
"##H############H    H #### H" +
"  H            H $  H #### H" +
"  H  $         H----H # $# H" +
"#######H            H #####H" +
"       H            H      H" +
"       H &        $ H  0   H" +
"############################",
