"                   #######  " +
"----------$      0S ######  " +
"H        H#H----   S ######H" +
"H       HX#XH $H$   S ##  #H" +
"H-------HX#XH ###H   S #$ #H" +
"H       HX#XH0###H    S ###H" +
"H0      HHHHH ###H     S ##H" +
"#-----  @XHX@ ###H      S #H" +
"##$  H  @XHX@    H       SSH" +
"###$ H  @XHX@ H--H---------H" +
"####$H  @XHX@ H             " +
"#####H0 @XHX@ H------H##$###" +
"     H  @XHX@ H     H@######" +
"     H  @XHX@ H    H@#######" +
"     H   &H   H    H@#######" +
"############################",
