"H                           " +
"H  --      -----------------" +
"H   S     $H    $    H   0 H" +
"### #######H-------H H H@@@@" +
" $         H $     H H H    " +
"@@@H### 0  H-------H H @@@@H" +
"   H $ #####    $  H H     H" +
" & H #####$#-------H H H@@@@" +
"H# H---------------H H H $  " +
"H#######X#####   0   H @@@@H" +
"H$  ####     #$  ####H     H" +
"H#############@@ ######H####" +
"H@############   ######H###$" +
"H@############H@ ##$###H####" +
"H@ $##########H@       H    " +
"H #######$    H@############",
