"    S                       " +
"    S              0        " +
"    S            H#####H    " +
" $H####H#H0    $ H#   #H    " +
"#H#####H#####H##H######H###H" +
"#H    @H $  @H @H  @# #H  $H" +
"#H ###@H @# @H @H $@# #H ##H" +
"#H $##@H   $@H @H # # #H ##H" +
"#H ###@H # #@H @H @@  #H ##H" +
"#H   $@H @   H$#H ##$ #H0 $H" +
"#H#####H#####HX#H######H###H" +
"$H------- $$ H  0 ##     @$H" +
"@@@H    ##@@@##H@@#$     $@H" +
"   H###$#@@@@@#H@@@@@@H@@@@H" +
"&  H#$##$$$$$$ H$     H    H" +
"@@@@@@####@@@@@@@###########",
