"S                           " +
"S      0          $         " +
"S @@H@@@@         @@@@H@@@@@" +
"S   H    #$      #    H# ---" +
"S---H-----#     #-----H@H  $" +
"#$  H  $   #   #      H#H-- " +
" #0 H--- #H # #   $   H@   H" +
"  #     # H  X        H#$  H" +
"&  #   #  H         $ H@ --H" +
"@@# # #   H# ------ # H#H   " +
"    #X    H # $    #  H@H 0 " +
"$H###     H  #    # $ H####H" +
"#H@-------H   #  #  ##H####H" +
" H             XX     H    H" +
" H                    H    H" +
"@@@@@@#######@@@@####@@@@@@@",
