"       H                    " +
" 0$    H                 $0 " +
"H##0$  H               $0##H" +
"H  ##  H####SH#####H   ##  H" +
"H           HH$    H       H" +
"H           $HH    H       H" +
"H           HH$            H" +
"H           $HH            H" +
"H           HH$            H" +
"H           $HH            H" +
"H           HH$            H" +
"H           $HH            H" +
"H           HH$            H" +
"H           $HH            H" +
"H       &   HH$            H" +
"H    H################H    H",
