"  S                         " +
"  S                         " +
"  S      -----        -----H" +
" 0H    -      H  -- 0H     H" +
"X#H---H #X##  H##  ##H ##X##" +
"X#    H##X### H##  ##H ##X# " +
"X#    H##0-   H##  ##H ##   " +
"X#    H##H ## H##  ##H- #   " +
"X# $  H##H$## H##$ ##$HXX$& " +
"X --H-H##H ## H##  ## H#### " +
"## HH  ##H  # H##  ## H#### " +
"##HH   ##H X -H##  ## H##   " +
"##H    ##H ##  ##  ## H##   " +
"##H $--##H  $   # $#  H   $ " +
"#####H ######H  ##X#  H####H" +
"#####H $#### H  $#X$  H#####",
