"              S             " +
"   --------  -S---          " +
"  H        H-     H H####H  " +
"  H-------0H------ H# H- #H " +
"  H       H#  --- H#  H $ XH" +
"  H      HX #H   H#   H   $#" +
"  H  -- H#   #H - &---H----#" +
"H #HHS H#$H## #H  #        #" +
"H# #HS H#######H  #### #####" +
"##X##S H#  #$ #H-H    -   0H" +
"##X##S H#######  H#### ####H" +
"# $ #S H# $#  #H H#$## ####H" +
"#####S H#######H H#### ##$#H" +
"#####S H#  #$  H H#    #   H" +
"#   #S H#######H H##X###X##H" +
"# $  S#H      #H#H   #  $  H",
