"                            " +
"         0     0        $ $S" +
"      H##############  H####" +
"      H ############  H#####" +
"H######  #$##$##$##  H######" +
"H#######           0H#######" +
"H#############X#########    " +
"H########$ $    $ $##### $$ " +
"H#########X###X#############" +
"H       0          $######  " +
"H  H#####H#####H  -H####  $H" +
"H  H  H  H  H  H   ###  $H##" +
"H  H$$H$$H$$H$$H   #  $H####" +
"H  H#####H#####H    $H######" +
"H              &   H########" +
"H###########################",
