"                            " +
"     ---S      ---    -   --" +
"H   H  -#@@@@@@   #### @@H  " +
"H$  H$  #   @$           H $" +
"##H-@@H @H  @@#@ XXXX## H#X#" +
" $H 0$H @H  @$          H   " +
"H##-H@@ @HH @@#H X    X H   " +
"H$  H$  @ HH  @H  #$$#  H   " +
"##H-@@H @  HH @H   ##H--H $ " +
"0$H  $H @   HH@H     H  ##X#" +
"H##-H@@ @    H@H  0  H      " +
"H$  H$0 @     @H@@@@@@@@H $ " +
"##H-@@H @     @H#  $ $ #H#X#" +
" $H  $H @     @H#H#@#@##H   " +
"H##-@@@ @0$$H# H#H $ $  H   " +
"H &     ######@@##@#@#@#@#@#",
