"#                         #S" +
"#      $  0   -----------$#S" +
"#############HH    0 $  H##S" +
"####         HH########### S" +
"#####  $  0  HH        ##  S" +
"#############HH  $    ###H S" +
"#######      HH########  H S" +
"   $  ##  $  HH     ###X#H S" +
"H############HH $  ##    H S" +
"H## # ####   HH##### $   H S" +
"H  H#H# $##  HH  #####X##H S" +
"@@@H H#H####&HH ## $     H S" +
"@@@@@H H# ###HH#####X####H S" +
"@@@@@@@HHH# #HH#         H S" +
"         H H HH          H S" +
"############################",
