"----------------            " +
"     $          H0          " +
"    $$$        HHH          " +
"    $$$        HHH          " +
"   $$         HH            " +
" $$ $$$     HH HHH  --------" +
"$$ $$  $$  HH HH  HH   0    " +
"   HH         HH      HHHHH " +
" 0 HHH        HHH     $$$$$ " +
"HHHH HH    HHHH HH    HHHHH " +
"     HH         HH    $$$$$ " +
"     HH       & HH    HHHHH " +
"############H###############" +
"            H               " +
"            H               " +
"############################",
