" ----$                $ $&#S" +
"     #H              H#####S" +
"     #H             HX#####S" +
"     #H            H#X##  #S" +
"     #H           H##X##$ #S" +
" $ 0 #H          H#$#X##XX#S" +
"####  #H        H# H#X##  #S" +
"$   #$ #H$     H# $H#X##  #S" +
"###H #  ##H   H####H#X##  #S" +
"$  #H #$ #H$0H# $ $H#X##  #S" +
"##H #H #  ##H######H#X##  #S" +
"$ #H #H #$ #H $ $ -H#X##  #S" +
"#H #H #H # #H##### H#X##XX#S" +
" #H #H #H          H#X##   S" +
"  H  H  H     0    H       S" +
"############################",
