"    --$ --------0----- -----" +
"   H $#$        H- # -H  $$$" +
"$&H $# #$      H- ### -H  $$" +
"## $#   #$    H- #   # -H  $" +
" 0 X  #  #   H- ##   ## -H 0" +
"H##  ###  @@@-   #$$$#   -#H" +
"H   #   #   $   HH###      H" +
"H  - ###   $H  H##H#       H" +
"H   - #   $H   H$$H -------H" +
"H    -   $H   H@@@@H       H" +
"@@@H  ---H    H$  $H ------H" +
"   H         H######H      H" +
"###H###H     H$    $H -----H" +
"       H    H@@@@@@@@H     H" +
"       H  0 H$   0  $H ----H" +
"########@@@@@########H     H",
