"                            " +
"          00 SS 00          " +
"         $$$S##S$$$         " +
"   $$$$$S@@@@@@@@@@S$$$$$   " +
"  S######          ######S  " +
"  SSS                  SSS  " +
"    S                  S    " +
"    S                  S    " +
"    S                  S    " +
"    S                  S    " +
"    S                  S    " +
"    S                  S    " +
"    S                  S    " +
"    S                  S    " +
"    S          &       S    " +
"@######@#####@@#####@######@",
