"S                          S" +
"S     $ 0  $     $  0 $    S" +
"SSSS########H   H########SSS" +
"            H   H           " +
"       H#############H      " +
"$  0  $H     $ $     H$ 0  $" +
"#######H $ $#####$ $ H######" +
"       H ####   #### H      " +
"    $  H      $      H $    " +
"  H######################H  " +
"  H           &          H  " +
"  H $    $H#######H$   $ H  " +
"##########H       H#########" +
"          H       H         " +
"  $       H       H      $  " +
"#@#@#@#@#@#@#@#@#@#@#@#@#@#@",
