"                            " +
"      SSSSSSS&S       S     " +
"    0    S    SS     SS0@   " +
"  $H$    S     SS   SS @@@  " +
" $HHH$   S      SS SS @@@@@ " +
"$HHHHH$  S       SSS @@@@@@@" +
"HHHHHHH--S  $0 $  S----HHH  " +
"   H    ############    H   " +
"  $@$   # $      $ #    H   " +
" $@@@$  # -------- #    H   " +
" @@@@@  # H      H #    H   " +
"  @@@   # H      H #    H   " +
"H#####H #$H   0  H$#    H   " +
"H     H ############    H   " +
"H     H  H        H     H   " +
"H#####HH############HH#####H",
