"#####################     S#" +
"# &##--- @@   $           S#" +
"# #@  $ H@@######HH H#H H S#" +
"# #     H    @@# HH$H H H S#" +
"# #H####@##$   # HH H H#H S#" +
"# #H#      @##   HH H H H S#" +
"#$ H#   $  #@# H# H H H H S#" +
"##HH##X#@###@# H#$#S##H#H S#" +
"##H      0     H#X#S# H H S#" +
"##H##@#######@HHH #S# H H S#" +
"##H #@#######@HH  #S# H H0H#" +
"# H  @  $    @H   #S#HH###H#" +
"# HH#@#######@H $ #S#H0   H#" +
"# #H#@#######@H@@@#S####  H#" +
"# #H#     $  @@#   S   #  H#" +
"# $H #@@@@@@@@@# 0 S   #####",
