"                            " +
"######HS            SH######" +
"###HHH$S            S$HHH###" +
"HH###HHH$          $HHH#X#HH" +
"$HHH#X#HHH$0    0$HHH###HHH$" +
"  $HHH###HHH$  $HHH#X#HHH$  " +
"    $HHH#X#HHHHHH###HHH$    " +
"      $HHH###HH###HHH$      " +
"        $HHH#HH#HHH$        " +
"      $HHH###HH###HHH$      " +
"    $HHH###HHHHHH#X#HHH$    " +
"  $HHH#X#HHH$  $HHH###HHH$  " +
"$HHH###HHH$      $HHH#X#HHH$" +
"HH#X#HHH$          $HHH###HH" +
"###HHH$S            S$HHH###" +
"######HS       &    SH######",
