"                            " +
"         H##    ##H         " +
"        H##      ##H        " +
"       H##        ##H       " +
"      H##$  0     $##H      " +
"  $--H################H--$0 " +
" H#H   ##$        $##   H#H " +
" HH#H   ## $    $ ##   H#HH " +
" $HH#H0  ####  ####   H#HH$ " +
"  $HH#H   ###  ###   H#HH$  " +
"   $HH#H   ##$&##   H#HH$   " +
"    $HH#H   ####   H#HH$    " +
"     $HH#H   HH   H#HH$     " +
"      $HH#H  HH  H#HH$      " +
"$  0   $H##H HH H##H$   0  $" +
"############################",
