"                           S" +
"                           S" +
"                     0-$$$-S" +
"  $-$-               H$###$H" +
"$H# # $-            $H#####H" +
"#H    #           $ #H##$##H" +
" H      $-        #H-H#####H" +
" H      #       $ -H  $###$ " +
" H              #H          " +
" H        $      H    $$$$  " +
" H        #   $ -H   $####$ " +
" H            #H     ####HX " +
" H         $-  H     ###HX# " +
" H         # $-H     ##HX## " +
" H          $# H     #HX### " +
" H  &       #  H 0   HX#### ",
