"-------------H--------------" +
" $      $    H   $   $ 0$  $" +
"0$  $    0 $ H $   $ $      " +
" #X##X#H H#X####H H#X#      " +
" #X##X##HH#X####XHH#X#      " +
" #X##X##XH#X####X#H#X#      " +
" #X#  ##XH#X#  #X#H#X#      " +
" #X#  ##XH#X#  #X#H#X#      " +
" #X#  ##XH#X#  #X#H#X#      " +
" #X#  ##XH#X#  #X#H#X#      " +
" #X# $##XH#X# $#X#H#X#      " +
" #X#X###XH#X#X##X#H#X###X## " +
" #X#X### H#X#X##X H#X###X## " +
" #X#X##  H#X#X##  H#X###X## " +
"         H   &    H         " +
"############################",
