"      0   S       S   0     " +
"           S     S          " +
"            S   S           " +
"          $###H###$         " +
"          #$#$H$#$#         " +
"  $      #$H H#H H$#    $ $ " +
"  ##H#H######H H######H#H## " +
" $# H#H      HHH      H#H$# " +
" # HH#HHHHHHHHHHHHHHHHH#HH #" +
" #H0$ #HHHHHHH#HHHHHHH# $0H#" +
"  ###H #H $  H H  $ H# H### " +
"   $##H#######H#######H##$  " +
"   ## H     $ H $     H ##  " +
"   # H##HHHHHH#HHHHHH##H #  " +
" $  H###HHH#HHHHH#HHH###H&$ " +
"############################",
