"@               @@@@@@@@@@@S" +
"@0        0     @  $ @     S" +
"@@------#####H &@ H@ @H@###S" +
"@#####   $  ###@@ H@ @H@###S" +
"@    ######       H@ @H@   S" +
"###H      ####H $ H@ @H@ $ S" +
"# ###@#H      H###@@ @H@###S" +
"#  $  ##@#H   H    @ @H@###S" +
"#####    ###@#H    @ @H@   S" +
"# $ #@H#     ##@##H@ @H@$$ S" +
"###   H##@@#  $  @H@ @H@###S" +
"# #@##H    ###@@#@H@ @H@###S" +
"#   ###@##H  $   @H@ @H@ ##S" +
"# H##   $###@@#H#@H@ @H@  #S" +
"# H#           H $H@  H   $S" +
"#$H#@####@#####@##@@##@#####",
