"-----------------------H    " +
"  $    $     $     $   H    " +
"####  ####  ###X  ##X# H    " +
"     $    $      $     H    " +
"#  #X##  ##X#  X###  # H    " +
" $      $   $      $   H    " +
"####  ####  ###X  ##X# H    " +
"    $     $     $      H    " +
"#  ##X#  #X##  X###  # H    " +
"  $     $     $    $   H    " +
"####  ####  ###X  ##X# H    " +
"0    &           0     H   0" +
"########################S###" +
"########################S###" +
"######################  S  #" +
"###################### 0S0 #",
