"             HH----HHHHH####" +
"            H##H---H$$ H####" +
"           H####H   HH$H H H" +
"          H######H    HH$H$H" +
"          H######H     HHHHH" +
"          H#@#@X@H     H H H" +
"          H$@#@X$H     H H H" +
"          H#@#@X@H     H$H$H" +
"$---------H#@#@X@H     HHHHH" +
"H$        H$@#@X$H     H H H" +
"#H$       H#@#@X@H     H H H" +
"##H$      H#@#@X@H     H$H$H" +
"###H$     H$###X$H     HHHHH" +
"####H$    H######H     H H H" +
"#####H$  H@# #@ #@H   &H$H$H" +
"######H 0H@# #@ #@H0 H######",
